
NO /Users/otamrani/Desktop/lm/cub3d/cub_3d/cub3d/texters/north.xpm
SO /Users/otamrani/Desktop/lm/cub3d/cub_3d/cub3d/texters/istockphoto-1224500457-612x612.xpm
WE /Users/otamrani/Desktop/lm/cub3d/cub_3d/cub3d/texters/number-42-logo-monogram-number-42-logo-line-style-usable-anniversary-business-logos_602671-1216.xpm
EA /Users/otamrani/Desktop/lm/cub3d/cub_3d/cub3d/texters/east.xpm

F 137,207,240
C 144,12,63

11111111111111111
10000000001100001
10110000000100001
100100W0000100001
10010000000100001
10010000000100001
11111111111111111